1111111111111111
1000000000000001
100CC00000C00001
10P0000000000E01
1111111111111111