111111111111111111111111111111
100000000000000000000000000001
100000010010000001000000111101
100000C1001C000001C000001C0001
100011110011110001111000100001
100000000000000000000000000001
101111100011111000001111100001
10001C0000001C0000000001C00001
10P000000000000000000000000E01
111111111111111111111111111111